######
#P   #
# XXX#
# OOO#
######
