     
##P##
#   # #  ####
#   #O###   #
#         X #
#  ## #     #
#  X        #
#     ##    #
#           #
## #     ###
  #O   ##
  #####
